                       
				
F     56, 54, 54  

NO textures/wall.xpm


     WE             textures/wall.xpm   
SO textures/wall.xpm   
C 130, 46, 46

EA           textures/wall.xpm


     11111111111             111111
    1111000000001           110111
   11111000010001
   100000000D0001
11110000000111111
10000100000111
10000D000E0011
100000110001111
111100000001
   111111111
